11111111
110C0111
1EP000C1
100000P1
11111111
