11111111
110C0111
11001111



1EP000C1
10000001
11111111
